###################################################
#J....#@@@@@@@@@@@@@@#.......#@@@@@@@@@@@@@@#....P#
#...#@#@@@@@@@@@@@##@#@#...#@#@##@@@@@@@@@@@#@#...#
#..##@@@@@@@@@@@@@@#@@@@#@#@@@@#@@@@@@@@@@@@@@##..#
#.#@@##################@#@#@#####################.#
##@@@@@@@@@@@@@@@@@@@@#@#@#@#@@@@@@@@@@@@@@@@@@@@##
#@@##################@#@#@#@#@##################@@#
#@@@@@@@@@@@@@@@@@@@#@@@#@#@@@#@@@@@@@@@@@@@@@@@@@#
###################@#####@#####@###################
#@@@@@@@@@@@@@@@@@@@#@@@#@#@@@#@@@@@@@@@@@@@@@@@@@#
#@###################@#@#@#@#@###################@#
#@@@@@@@@@@@@@@@@@@@#@#@#@#@#@#@@@@@@@@@@@@@@@@@@@#
###################@#@#@#@#@#@#@###################
#.##@@@@@@@@@@@@@@@@#@#@#@#@#@#@@@@@@@@@@@@@@@@##.#
#..###@@@############@#@#@#@#@############@@@###..#
#....###@@@@@@@@@@@@#@#@#@#@#@#@@@@@@@@@@@@###....#
#......############@#@#@#@#@#@#@############......#
##.......###@@@@@@@@#@#@#@#@#@#@@@@@@@@###.......##
###.........###@@@@##@#@#@#@#@##@@@@###.........###
#####.........####@@@@#@#@#@#@@@@####.........#####
#######..........###@##@#@#@##@###..........#######
##########.........#@@#@@@@@#@@#.........##########
###################################################