####################
#J........@.......P#
#.###..#..###......#
#..@#..#..#..@###..#
#@#.......#.####...#
######.............#
#@.........####....#
###..##............#
#....#@######.##...#
#.#..#.#@.@.#...##.#
#.#....##.#@#...#@.#
#.###..##..###..##.#
#..@#...........#@.#
####################